1111111111111111111111111
1000000000000000000000001
1010111110111111101111101
1010000000000000101000001
1010111111111110101011101
1000100000000000101000001
1010101110111011101111101
1010101110000000000000001
1010101110111101110111111
1010101110000001110000001
1010000000111100000111101
1011110110111111110100001
1010000000000000000001111
1000111101111101011100001
1010111101111101000101101
1010111101111101110001101
1010000000000000000100001
1010101111101111110111111
1000100000000000010000001
1011111101111111010111101
1000000000000000010111101
1011111111101111010000001
1011110001000100010111101
1000000100010001010000001
1111111111111111111111111
